가게	店铺		
가격	价格		
가구	家具		
가깝다	近		
가끔	间或，时而		
가다	去		
가르치다	教		
가방	包		
가볍다	轻		
가수	歌手		
가슴	胸		
가요	歌谣		
가운데	中间		
가위	剪刀		
가을	秋天		
가장	最		
가져가다	拿走		
가져오다	拿来		
가족	家族		
가지	种类	종류	
가지다	拥有，拿着		
각	各		each
간단하다	简单的		
간단히	简单地		
간식	零食		
간장	肝脏		
간호사	护士		
갈비	排骨		
갈비탕	排骨汤		
갈색	褐色		
갈아타다	换乘		
감	柿子	과일	
감기	感冒		
감다	缠绕		
감동	感动		
감사하다	感谢		
감자	土豆		
갑자기	突然		
값	价格		
강	江, 河	江	
강아지	小狗		
갖다	拥有，拿着	가지다' 축약	
같다	一样，相同		
같이	一起		
개	个	한 ~	
개03	狗	동물	dog
개나리	迎春花		
개월	(几)个月		
개인	个人		
거	东西	것	同것
거기	那里		
거리	大街		
거실	客厅，居室		
거울	镜子		
거의	几乎		almost
거짓말	谎言		
걱정하다	担心		
건강하다	健康		
건너가다	越过		
건너다	渡		
건너편	对面		
건물	建筑物		
걷다	走(路)	길을 ~	
걸다	挂		
걸리다	被…挂上		
걸어가다	走去		
걸어오다	走来		
검은색	黑色		
것	依存名词		
게임	游戏		game
겨울	冬天		
결과	结果		
결정하다	决定		
결혼식	婚礼		
결혼하다	结婚		
경기	竞赛		
경기장	赛场		
경복궁	景福宫		
경주04	庆州	지명	
경찰	警察		
경찰관	警官		
경찰서	警署		
경치	风景		
경험	经验		
계단	阶段		
계란	鸡蛋		
계산하다	计算		
계속	继续		
계시다	在…		있다对应的敬语
계절	季节		
계획	计划		
고기	鱼		
고등학교	高中		
고등학생	高中生		
고르다	挑选		
고맙다	感谢		
고모	姑姑		
고모부	姑父		
고속버스	高速大巴		
고양이	猫		
고장11	故障	~이 나다	
고추	辣椒		
고추장	辣椒酱		
고치다	修理		
고프다	饿		
고향	故乡		
곧	立刻		
골목	胡同		
골프	高尔夫		golf
곱다	漂亮		
곳	地方		
공	零		电话号码零读공
공간	空间		
공기	空气		
공무원	公务员		
공부	学习		
공연	演出		公演
공원	公园		
공중전화	公用电话		
공짜	不花钱的		
공책	笔记本		
공항	飞机场		空港
공휴일	公休日		
과10	课	課	
과거	过去		
과일	水果		
과자	饼干		
과학	科学		
관계	关系		
관광하다	旅游		
관심	关心		
광고	广告		
괜찮다	不错		
교과서	教科书		
교수	教授		
교실	教室		
교통	交通		
교통사고	交通事故		
교회	教会		
구	九		
구경하다	观看		
구두	皮鞋		
구름	云		
구십	九十		
구월	九月		
구하다	救		
국01	汤	음식	
국내	国内		
국립	国立		
국수	面条		
국어	国语		
국적	国籍		
국제	国际		
군인	军人		
굽다01	烤	고기를 ~	
권	册		
귀	耳朵	신체(耳)	
귀엽다	可爱		
규칙	规则		
귤	橘子		
그	那		冠词接在名词前修饰名词
그거	那个		그거是그것的口语
그것	那个		
그곳	那地方		
그날	那天		
그냥	仍然、仍旧		
그동안	这段时间		
그때	当时		
그래	对		OK, All Right
그래서	所以		
그램	克	(g)	gram
그러나	但是		
그러니까	所以		是그래서对应的口语
그러면	那么		
그런	那样的		
그런데	但是		
그럼01	那么	'그러면' 축약	그러면的缩略
그렇다	1、状态、摸样、性质相同 2、没有特别的变化 3、不满意		
그렇지만	但是		
그릇	盘子		
그리고	而且		and
그리다	画	그림을 ~	
그림	画		
그만	中止		
그분	那位		
그저께	前天		
그쪽	那边		분是用于人的敬语
그치다	停歇		
극장	剧场		
근처	附近		
글	文字		
글쎄요	是呀		well
금방	刚刚		
금연	禁烟	禁煙	
금요일	星期五		
급하다	紧急的		
기간	期间		
기다리다	等		
기르다	养		
기름	油		
기분	气氛		
기뻐하다	高兴		
기쁘다	高兴		
기사02	司机	택시~	
기사10	新闻	신문~	
기숙사	宿舍		
기억하다	记忆		
기온	气温		
기자	记者		
기차	火车		
기침	咳嗽		
기타	吉他	악기	
긴장되다	状态紧张或兴奋		
길	路		
길다02	长	머리가 ~	状态动词
김밥	紫菜饭卷		
김치	泡菜		
김치찌개	泡菜汤		
김포공항	金浦机场		
까만색	黑色		
까맣다	黑		
깎다	削、切		
깜짝	(吓)一跳		
깨끗하다	干净		
깨다02	打破	유리를 ~	
깨지다	被打碎		
꺼내다	拿出		
껌	口香糖		
꼭	紧紧、必须地		tight, exactly
꽃	花		
꽃집	花店		
꾸다	作(梦)	꿈을	
꿈	梦		
끄다	熄(灭)		
끓이다	烧开		
끝	结束		
끝나다	结束		
끝내다	被结束		
끼다02	笼罩(雾气)	안개가 ~	
끼다03	戴(戒指)	반지를 ~	
나	我		
나가다	出去		
나누다	分配		
나다01	发生、出现	열이~	
나라	国家		
나무	树		
나빠지다	变坏		
나쁘다	坏		
나오다	出来		
나이	年龄		
나중	以后		
나타나다	出现		
나흘	四天		
낚시	垂钓		
날	天		
날씨	天气		
날짜	日期		
남기다	剩下		
남녀	男女		
남대문시장	南大门市场		
남동생	弟弟		
남미	南美		
남산	南山		
남자	男子		
남쪽	南边		
남편	丈夫		
남학생	男同学		
낮	白天		
낮다	低、矮		
내과	内科		
내년	明年		
내다02	开(路)	길을 ~	
내려가다	下去		
내려오다	下来		
내리다	降下来		
내용	内容		
내일	明天		
냄비	平底锅		
냄새	味道		
냉면	冷面		
냉장고	冰箱		冷藏库
너	你		
너무	太		too
넓다	宽		
넘다	超过		
넘어지다	倒下		
넣다	装进		
네	是		
네	四	~ 명	后面有量词的时候넷->네
넥타이	领带		
넷	四		
넷째	第四		
년	年	십 ~	
노란색	黄色		
노랗다	黄		
노래	歌曲		
노래방	练歌房		
노력하다	努力		
노트	笔记		note
녹색	绿色		
녹차	绿茶		
놀다	玩		
놀라다	吃惊		
농구	篮球		
높다	高		
놓다	放		
누구	谁		whom
누나	姐姐		
누르다	按		
눈01	眼睛	신체	
눈04	雪	~이 내리다	
눈물	眼泪		
눈사람	雪人		
눈싸움02	打雪仗		
눕다	躺		
뉴스	新闻		
뉴욕	纽约		
느끼다	感到		
느낌	感受		
느리다	慢		
늘	常		
늘다	增加		
능력	能力		
늦다	迟		
님	尊称	선생-	用于职位、头衔后
다	全部		这是口语
다녀오다	去过		
다니다	通行		表示往返多次的情况，比如上班、上学
다르다	不同		
다른	不同		
다리01	腿	신체	
다리02	桥	~를 건너다	
다섯	五		
다시	再		
다음	下面		
다이어트	节食		
다치다	触碰、受伤		
닦다	擦		
단어	单词		
단점	缺点		
닫다	关(门)		
닫히다	被关上		
달	月份	한 ~	
달	月亮	~이 밝다	
달다07	甜	맛	
달러	美元		dollar
달력	月历		
달리다04	(水果等)垂挂		
닭	鸡		
닭고기	鸡肉		
닮다	像		
담그다	浸，泡		
담배	香烟		
답장	回复		
당근	胡萝卜		
당신	您		
대	辆	차 한 ~	车的量词
대답하다	回答		
대부분	大部分		
대사관	大使馆		
대학	大学		大学
대학교	大学		大学校
대학생	大学生		
대학원	研究生院		
대학원생	研究生		
대한민국	大韩民国		
대화	对话		
대회	大会		
댁	府上		
더	更加		
더럽다	脏		
덕분	多亏		德分
덥다	热		
덮다	盖上		
데리다	带领		
데이트	约会		date
도로	道路	道路	
도서관	图书馆		
도시	都市		
도와주다	给帮忙		
도움	帮助		
도착하다	到达		
도쿄	东京		
독서	读书		
독일	德国		
돈	钱		
돌아가다	回去		
돌아오다	回来		
돕다	帮助		
동네	邻里、小区		
동대문시장	东大门市场		
동물	动物		
동생	弟弟，妹妹		
동아리	(大学)社团		
동안	期间	방학 ~	
동양	东洋，东方	東洋	
동전	硬币		
동쪽	东边		
돼지	猪		
돼지고기	猪肉		
되다	成为		
된장	大酱		
된장찌개	大酱汤		
두	两	~ 명	后面必须有量词
두껍다	厚		
두다	放，搁		
두부01	豆腐	음식	
둘	两		
둘째	第二		
뒤	后面		
드라마	电视剧		drama
드리다	奉上		
드시다	吃		
듣기	听		
듣다	听		
들다04	提	가방을 ~	
들어가다	进去		
들어오다	进来		
등	背	신체	
등산	登山		
등산복	登山服		
등산화	登山鞋		
디자인	设计		design
따뜻하다	暖和		
따라가다	跟去		
따라오다	跟来		
따로	单独地		
딸	女儿		
딸기	草莓		
땀	汗		
때	污垢		
때문	原因		
떠나다	离开		
떠들다	(大声)喧哗		
떡	糕		
떡국	打糕汤		
떡볶이	炒年糕		
떨어지다	掉		
또	又		
또는	或		
똑같다	完全一样		
똑바로	端正地		
뛰다	跳		
뜨겁다	烫		
뜻	意思		
라디오	广播		
라면	方便面		
러시아	俄罗斯		
로션	爽肤水		
마늘	大蒜		
마르다	干涸	목이 ~	
마리	头，只	한 ~	动物的量词
마시다	喝		
마음	心		
마지막	最后		
마치다02	完成		
마흔	四十		
막히다	堵塞		
만	万	萬	
만나다	遇到		
만두	饺子		
만들다	做，造		
만지다	摸		
만화	漫画		
많다	多		
많이	多地		
말01	话	~과 글	
말씀하다	话语(敬语)		
말하기	说		
말하다	说		
맑다	清澈		
맛	味道		
맛없다	不好吃		
맛있다	好吃		
맞다01	合适		
맞은편	对面		
매다	系		
매우	非常、十分		
매일	每天		
매주	每周		
맥주	啤酒		
맵다	辣		
머리	头，脑瓜	신체(首)	
머리	头发	머리카락	
먹다	吃		
먼저	先		
멀다	远		
멋있다	帅		
메뉴	菜单		
메다	背，挑，扛		
메모	纸条		
메시지	信息、口信		memo
멕시코	墨西哥		message
며칠	几天		
면도	刮脸	面刀	
명	个		
명절	节日		
몇	几，多少		
모두	全部地		
모든	所有的		
모레	后天		
모르다	不知道		
모시다	侍奉(父母、老人)		
모양	模样		
모으다	收集		
모이다	被收集		
모임	聚会		
모자	帽子		
목	脖子		
목걸이	项链		
목소리	嗓音		
목요일	星期四		
목욕하다	洗澡		
목적	目的		
몸	身体		
몸살	浑身痛		
못	不能…		
못하다	做不好		
몽골	蒙古		
무	萝卜	야채	
무겁다	重		
무궁화	木槿花		木槿是韩国国花
무료	免费		
무릎	膝盖		
무섭다	害怕		
무슨	什么		what kind of
무엇	什么		what
무역	贸易		
무용	舞蹈		
무척	非常、十分		
문	门	門	
문구점	文具店		
문장	文章		
문제	问题	問題	
문화	文化		
묻다03	询问	길을 ~	
물	水		
물건	物品		
물론	当然		
물어보다	询问		
뭐	什么		뭐 等于 무엇을
미국	美国		
미래	未来		
미리	预先		
미술	美术		
미술관	美术馆		
미안하다	对不起		
미용실	美容院		
미터	米	(m)	
민속촌	民俗村		
밀가루	面粉		
밀리다	被拖延		
밑	下面	아래	
바꾸다	替换		
바뀌다	被替换		
바나나	香蕉		
바다	大海		
바닷가	海边		
바라다	希望		
바람	风		
바로	笔直地、直接地		
바르다01	涂，抹	화장품을 ~	
바쁘다	忙		
바이올린	小提琴		
바지	裤子		
박물관	博物馆		
박수	鼓掌		
밖	外边		
반07	半	半	
반10	班	班	
반갑다	高兴		用于见到久违的朋友后高兴的情景
반바지	短裤		
반지	戒指		
반찬	菜肴		
받다	收		
발	脚		
발가락	脚趾		
발음	发音		
발표	发表		
밝다	明亮		
밤01	夜晚	↔낮	
밥	饭		
방	房间		
방법	方法		
방송	广播		
방송국	电视台/广播局		放送局
방학	放假		
배01	腹、肚子	신체	
배02	船	~를 타다	
배03	梨	과일	
배고프다	肚子饿		
배구	排球		
배달	投递		
배부르다	肚子饱		
배우	演员		
배우다	学习		
배탈	腹痛		
백	一百		
백화점	百货店		
버리다	扔掉		
버스	公共汽车		
번	号，次	番	
번호	号码		
벌다	赚(钱)		
벌써	早已		
벗다	脱		
벚꽃	樱花		
베이징	北京		
베트남	越南	Vietnam	
벽	墙壁		
변호사	律师		
별	星星	星	
별로	不怎么		后接否定
병	瓶	한 ~	
병04	病	~에 걸리다	
병원	医院		
보내다	送		
보다	观看		
보이다	被看见		
보통	通常		
복숭아	桃子		
복잡하다	复杂		
볶다	炒		
볶음밥	炒饭		
볼펜	圆珠笔		
봄	春天		
봉지	纸袋		
봉투	信封		
뵙다	看望		
부동산	房地产		不动产
부드럽다	柔软		
부르다	呼唤		
부모	父母		
부부	夫妇		
부산	釜山	지명	
부엌	厨房		
부인	夫人	夫人	
부지런하다	勤快		
부치다	寄		
부탁	嘱托		
북	鼓	악기	
북쪽	北边		
분01	位	선생님 한 ~	
분08	分	시간	
분위기	氛围		
불	火		
불고기	烤肉		自动词
불다	吹		他动词
붓다	倒(液体)		
붙다	粘		
붙이다	粘		
브라질	巴西		
블라우스	短袖衫		
비	雨	~가 오다	
비누	肥皂		
비디오	视频		
비밀	秘密		
비빔밥	拌饭		
비슷하다	相似		
비싸다	贵		
비행기	飞机		
빌딩	大厦		building
빌리다	借		
빠르다	快		
빨간색	红色		
빨갛다	红		
빨다02	洗	옷을 ~	
빨래	(要洗的)衣物		
빨리	快点		口语
빵	面包		
빵집	面包店		
빼다	减去		
사	四		
사거리	十字路口		
사계절	四季		
사고	事故	~가 나다	
사과	苹果	과일	
사다	购买		
사람	人		
사랑하다	爱		
사무실	办公室		
사물	事物		
사십	四十		
사업가	企业家		
사용하다	使用		
사원	职员		
사월	四月		
사이	(两个)之间		
사이다	汽水	음료수	
사이즈	尺寸		size
사인하다	签字		
사장	社长		
사전	辞典		
사진	照片		
사진기	相机		
사촌	堂兄弟，堂姐妹		
사탕	糖		
사흘	三天		
산	山		
산책	散步		
살	岁	나이	
살다	生活		
삼	三		
삼거리	三岔路口		
삼계탕	参鸡汤		
삼십	三十		
삼월	三月		
삼촌	叔（父）		
상자	箱子		
상처	伤口		
상품	商品		
새	新	↔ 헌	new
새	鸟	동물	
새로	新		
새벽	凌晨		
새우	虾		
색	颜色		
색깔	颜色		
샌드위치	三明治		
생각하다	思考		
생기다	发生		
생선	活鱼		
생신	生辰		
생일	生日		
생활	生活		
샤워하다	淋浴		
샴푸	洗发水		shampoo
서다	站立		
서로	相互		
서류	文件		
서른	三十		
서비스	服务		
서양	西洋	西洋	
서울	首尔		
서울역	首尔站		
서점	书店		
서쪽	西边		
선물하다	馈赠		
선배	前辈		
선생님	老师		
선수	选手	운동~	
선택하다	选择		
선풍기	电风扇		
설거지	洗刷碗筷		
설날	春节		
설렁탕	牛杂碎汤		
설명하다	说明		
설악산	雪岳山		
설탕	白糖		
섬	岛		
성	姓	姓	
성격	性格		
성함	姓名		
세	三	나이, 20 ~	
세	三		
세계	世界		
세수하다	洗脸		
세우다	竖立		
세일하다	大减价		sale
세탁기	洗衣机		
세탁소	洗衣店		
센터	中心		
센티미터	厘米		
셋	三		
셋째	三		
소	牛		
소개하다	介绍		
소고기	牛肉		
소금	盐		
소리	声音		
소설	小说		
소설가	小说家		
소식	消息		
소파	沙发		
소포	包裹		
소풍	兜风		
소화제	消化剂		
속	(事物的)里面		
손	手		
손가락	手指		
손님	客人		
손수건	手绢		
송이	朵		云彩的量词
쇼핑	购物		
수건	毛巾		
수도09	首都	首都	
수돗물	自来水		
수박	西瓜		
수술하다	手术		
수업	上课		
수영	游泳		
수영복	泳衣		
수영장	泳池		
수요일	星期三		
수저	勺和筷		
수첩	手册		
수학05	数学	數學	
숙제	作业		
순서	顺序		
숟가락	勺子		
술	酒		
쉬다03	休息	주말에 ~	
쉰	五十		
쉽다	容易		
슈퍼마켓	超市		
스물	二十		
스웨터	毛衣		
스케이트	滑冰		
스키	滑雪		
스키장	滑雪场		
스타킹	长筒袜		
스트레스	疲劳		
스페인어	西班牙语		
스포츠	体育		
슬퍼하다	伤心		
슬프다	伤心		
습관	习惯		
시06	市	市	
시10	时，点	時	
시간	时间		
시간	时，点	한 ~	
시간표	时间表		
시계	钟表		
시골	农村		
시끄럽다	嘈杂		
시내	市区		
시다01	酸	맛	
시디01	光盘	CD	
시민	市民		
시설	设施		
시외	远郊		
시원하다	凉快		
시월	十月		
시작	开始		
시장	市场		
시청	收看		
시키다	使唤		
시험	考试		
식당	食堂		
식사	吃饭		
식탁	饭桌		
신다	穿		
신문	报纸		
신발	鞋		
신청서	申请书		
신청하다	申请		
신호등	信号灯		
실례하다	失礼		
실수	失误		
싫다	烦		
싫어하다	讨厌		
심하다	过分		
십	十		
십이월	12月		
십일월	11月		
싱겁다	(味道)淡		
싸다01	裹(东西)	짐을 ~	
싸다05	便宜	값이 ~	
싸우다	打架		
쌀	大米		
쌓이다	堆积		
썰다	切		
쓰기	写作		
쓰다01	写	글을 ~	
쓰다02	戴(帽子)	모자를 ~	
쓰다03	使用	사용하다	
쓰다06	(味道)苦	맛	
쓰레기	垃圾		
쓰이다	被使用		
씨	氏	홍길동 ~	
씩	每	조금-	每次
씹다	嚼	껌을 ~	
씻다	洗		
아가씨	小姐		
아기	婴儿、小孩		
아까	刚才		
아내	妻子		
아니다	不是		
아니요	不是		
아들	儿子		
아랍어	阿拉伯语		
아래	下面		
아름답다	漂亮		
아마	恐怕		
아무	任何人		
아버지	父亲		
아빠	爸爸		
아시아	亚洲		
아이	孩子		
아이스크림	冰激凌		
아저씨	大叔		
아주	非常		
아주머니	大妈		
아줌마	大妈		比 아주머니更口语化
아직	尚未		
아침	早晨	시간	
아침	早饭	아침밥	
아파트	公寓		
아프다	疼		
아프리카	非洲		
아홉	九		
아흔	九十		
악기	乐器		
안	不		
안	内	건물 ~	
안경	眼镜		
안내하다	介绍、引导		
안녕하다	安宁		
안녕히	安宁		相当于您好，再见
안다	抱		
안전하다	安全		
앉다	坐下		
알다	知道		
알리다	告诉		
알맞다	合适		
앞	前面		
액세서리	饰品		accessory
야구	棒球		
야채	蔬菜		
약	大约	대략	
약	药	~을 먹다	
약간	若干、一点		
약국	药房		
약사	药剂师		
약속	约定		
얇다	薄		
양	量	量	
양말	袜子		
양복	西服		
양식	西餐	洋食	
양파	洋葱		
얘기하다	讲话		
어깨	肩膀		
어느	哪、某		which
어둡다	昏暗		
어디	哪里		where
어떤	什么样的		what
어떻다	怎么样、如何如何		
어렵다	困难		
어른	成年人		
어리다	年轻、不成熟		
어린이	儿童		
어머	天哪		
어머니	母亲		
어서	快		
어울리다	协调		
어제	昨天		
어젯밤	昨夜		
언니	姐姐		
언제	什么时候		
언제나	无论什么时候		
얼굴	脸		
얼마	多少		
얼마나	多么地		
얼음	冰		
엄마	妈妈		
없다	没有		
없이	一点没有地		
에어컨	空调		
엘리베이터	电梯		
여권	护照		
여기	这里		
여기저기	到处		
여덟	八		
여동생	妹妹		
여든	八十		
여러	多个		
여러분	各位		
여름	夏天		
여보세요	喂		
여섯	六		
여자	女子		
여학생	女学生		
여행	旅行		
여행사	旅行社		
역	(车)站		
역사	历史		
연락처	联络处		
연세	年龄		用于长辈
연습하다	练习		
연예인	艺人		
연필	铅笔		
연휴	连休		
열	(发)烧	~이 나다	
열	十		
열다	打开		
열리다	被打开		
열쇠	钥匙		
열심히	认真地		
열차	列车		
엽서	明信片		
영국	英国		
영상	零上	기온	
영어02	英语		
영하	零下	기온	
영화	电影		
영화관	电影院		
영화배우	电影演员		
영화표	电影票		
옆	旁边		
예	是		yes
예쁘다	美丽		
예순	六十		
예약	预约		
옛날	以前、古时候		
오	五		
오늘	今天		
오다	来		
오래	很久		
오래간만	很久之后		
오랜만	很久之后		
오랫동안	很长时间		
오렌지	橙子		orange
오르다	上升		
오른쪽	右边		
오리	鸭子	동물	
오빠	哥哥		
오십	五十		
오월	五月		
오이	黄瓜	채소	
오전	上午		
오징어	鱿鱼		
오후	下午		
올라가다	上去		
올라오다	上来		
올려놓다	放上去		
올림픽	奥林匹克		
올해	今年		
옮기다	搬		
옷	衣服		
옷장	衣柜		
와	哇		
와이셔츠	衬衫		
왜	为什么		
왜냐하면	因为		
외국	外国		
외국어	外语		
외국인	外国人		
외롭다	孤独		
외삼촌	舅舅		
외숙모	舅妈		
외출하다	外出		
외할머니	外婆		
외할아버지	外公		
왼쪽	左边		
요금	费用		
요르단	约旦		
요리	菜肴		
요일	星期		
요즘	最近		
우리	我们		
우리나라	我们国家		
우산	雨伞		
우선	首先		
우유	牛奶		
우체국	邮局		
우표	邮票		
운동복	运动服		
운동선수	运动员		
운동장	操场		
운동하다	运动		
운동화	运动鞋		
운전하다	安全		
울다	哭泣		
울리다	弄哭		
움직이다	动		
웃기다	使人笑		
웃다	笑		
원	韩元	好的，我们可以将“원”字的四个部分进行形象化编码，创造一个容易记住的名字。 拆分并形象化    ㅇ (初音)：  形象：像一个鸡蛋（egg），象征着新生命和开始。     ㅗ (中间音)：  形象：像一个小碗（bowl），可以用来盛食物，象征着丰盛和滋养。     ㅜ (下音)：  形象：像一个水滴（drop），代表流动和变化。     ㄴ (收音)：  形象：像一把钥匙（key），象征着开启和连接。    组合名字  将这些形象结合起来，可以创造一个有趣的名字：  “鸡蛋碗水滴钥匙”（Egg Bowl Drop Key）  记忆联想  想象你在厨房里：有一个鸡蛋放在碗里，碗旁边有水滴，水滴下方是钥匙。这个场景可以帮助你更生动地记住“원”的构成和发音。   通过这样的象形化和联想，你可以更容易地记住“원”这个单词。	
원피스	连衣裙		
원하다	期望		
월	月		
월급	月薪		
월드컵	世界杯		
월세	月租金		
월요일	星期一		
웬일	什么事、某个事情		
위	上面	~에	
위치	位置		
위하다	为了		
위험하다	危险		
유럽	欧洲		
유리	玻璃		
유명하다	有名		
유월	六月		
유학	留学		
유학생	留学生		
유행	流行		
육	六		
육십	六十		
은행	银行		
은행원	银行职员		
음료수	饮料		
음식	食物		
음악	音乐		
음악가	音乐家		
응	嗯		
의미	意思		
의사	医生		
의자	椅子		
이03	牙	신체(齒)	
이05	二		
이09	二		
이거	这个		
이것	这个，指近处的事物		
이곳	此地		
이따가	等一会儿		
이런	这些		
이렇다	这样的		
이름	名字		
이메일	电子邮件	e-mail	
이모	姨		
이모부	姨夫		
이번	这次		
이분	这位		
이사	搬家		
이상하다	奇怪		
이십	二十		
이야기하다	说话		
이용하다	利用		
이월	二月		
이유	理由		
이제	从现在开始		
이집트	埃及		
이쪽	这边		
이틀	两天		
이해하다	理解		
인구	人口		
인기	人气		
인도	印度		
인사하다	打招呼		
인삼	人参		
인상06	印象	~이 좋다	
인천	仁川		
인터넷	互联网		
인터뷰하다	面谈、采访		
인형	人偶		
일	一		
일07	日	日	
일곱	七		
일기12	日记	~를 쓰다	
일기예보	天气预报		
일본	日本		
일본어	日语		
일상생활	日常生活		
일식04	日食	日食	
일어나다	起来		
일요일	星期天		
일월	一月		
일주일	一周		
일찍	早地		
일하다	干活		
일흔	七十		
읽기	读、阅读		
읽다	朗读		
잃다	丢失		
잃어버리다	丢掉		
입	嘴		
입구	入口		
입다	穿		
입원하다	住院		
입학	入学		
있다	存在，有		
잊다	忘记		
잊어버리다	忘掉		
자04	好，来		近似于 come on
자기	自己		
자다	睡觉		
자동차	汽车		
자료	资料		
자르다	剪断		
자리	座位		
자신01	自信		
자연	自然		
자유	自由		
자장면	炸酱面		
자전거	自行车		
자주	常常		
작년	去年		
작다	小		
작은아버지	叔父		
작은어머니	叔母		
잔	杯	커피 한 ~	
잔치	庆典		如结婚仪式等庆典
잘	好地、帮地		
잘못	错误地		
잘생기다	长得帅，漂亮		
잘하다	做得好		
잠	睡眠		
잠깐	稍微		
잠시	暂时		
잠자다	睡觉		
잡다	抓住	손을 ~	
잡수시다	用膳		
잡지	杂志		
장	张	종이 한 ~	
장갑	手套		
장마	雨季、淫雨		
장마철	雨季		
장미	玫瑰		
장소	场所		
장점	优点		
재료	资料		
재미없다	无趣		
재미있다	有趣		
재킷	夹克		jacket
저	鄙人		
저03	那		
저거	那个		
저것	那个		
저곳	那个地方		
저기	那边		
저녁	晚上	시간	
저녁	晚饭	저녁밥	
저분	那位		
저쪽	那边		
저희	我们		
적다	少	수량	
적다	写	쓰다	write
전07	全部	全(모든)	
전08	前	前	
전공	专业		
전자사전	电子词典		
전하다	传递(口信)		
전혀	全然		
전화	电话		
전화기	电话机		
전화번호	电话号码		
절01	寺	寺	
젊다	年轻		
점수	分数		
점심	中午	시간	
점심	午饭	점심밥	
점심시간	午餐时间		
점원	店员		
점퍼	夹克		
젓가락	筷子		
정거장	车站		
정도	程度		
정류장	车站		
정리하다	整理		
정말	确实、非常		
정문	正门		
정보	信息		
정하다	确定		
제목	题目		
제일	第一		
제주도	济州岛		
조금	一点，一丁点		
조사하다	调查		
조심하다02	小心		
조용하다01	安静		
조용히	安静地		
조카	侄子，侄女		
졸업하다	毕业		
좀	稍微		
좁다	狭窄		
종로	钟路		
종류	种类		
종업원	职员		
종이	纸		
종일	整天		
좋다	好		
좋아하다	喜欢		
죄송하다	过意不去		
주	周	이번 ~	
주	周	다음 ~	
주다	给予		
주로	主要地		
주말	周末		
주머니	口袋		
주무시다	休息		
주문하다	订购		
주변	周边		
주부	主妇		
주사	注射	~를 맞다	
주소	地址		
주스	果汁		juice
주위	周围		
주인	主人		
주차장	停车场		
주차하다	停车		
주황색	橘黄色		
죽	粥		
죽다	死		
준비하다	准备		
줄01	行列	~을 서다	
줄다	减少		
중04	中间	상, ~, 하	
중국	中国		
중국어	中文		
중국집	中国料理		
중식	中餐	中食	
중심	中心		
중요하다	重要		
중학교	中学		
중학생	中学生		
즐거워하다	喜欢		
즐겁다	愉快		
즐기다	欢度、安享		enjoy
증세	症状		
지갑	钱包		
지금	现在		
지나다	经过		
지난달	上个月		
지난번	上次		
지난주	上周		
지내다	过日子		
지도	地图	地圖	
지방	地方		
지우개	橡皮		
지키다	看守	약속을 ~	
지하	地下		
지하도	地道		
지하철	地铁		
지하철역	地铁站		
직업	职业		
직원	职员		
직장	公司		
직접	直接		
진달래	金达莱		
질08	品质	品質	
질문하다	提问		
짐	行李		
집	房子		
짓다	盖		
짜다	咸		
짜리	表示一个的价格	백 원~	
짧다	短		
쪽	页	페이지	page
쯤	左右	내일-	about
찌개	炖的汤		
찍다	劈		
차05	汽车	자동차	
차08	茶	~를 마시다	
차갑다	凉		
차다02	踢	공을 ~	
차리다	张罗		
착하다	善良		
참	真正地		
창문	窗户		
찾다	找		
찾아가다	找去		
찾아오다	找来		
채소	蔬菜		
책	书		
책상	桌子		
책장	书柜		
처음	第一次		
천	千		数词
천천히	慢慢地		
철01	季节	계절	
첫	第一次		
첫째	第一		
청바지	牛仔裤		
청소기	吸尘器		
청소하다	打扫		
초대하다	招待		
초등학교	小学		
초등학생	小学生		
초록색	翠绿色		
초콜릿	巧克力		
촬영하다	摄影		
최고	最佳		top
추다	跳	춤을 ~	
추석	中秋节		
추억	回忆		
축구	足球		
축제	庆典		
축하하다	庆祝		
출구	出口		
출근하다	上班		
출발하다	出发		
출장	出差		
춤	舞蹈		
춤추다	跳舞		
춥다	冷		
취미	爱好		
취소하다	取消		
취직하다	就职		
층	层		
치과	牙科		
치다	打	테니스를 ~	
치료하다	治疗		
치마	裙子		
치약	牙膏		
친구	朋友		
친절하다	亲切		
친척	亲戚		
친하다	亲密		
칠	七		
칠십	七十		
칠월	七月		
칠판	黑板		
침대	床		
칫솔	牙刷		
카드	卡片	생일 ~	
카레	咖喱		
카메라	照相机		
카페	咖啡馆		
칼	刀		
캐나다	加拿大		
커피	咖啡		
커피숍	咖啡厅		
컴퓨터	电脑		
컵	杯子		
케이크	蛋糕		
켜다	开	텔레비전을 ~	
코	鼻子		
코트	外套		
코피	鼻血	~가 나다	
콜라	可乐		
콧물	鼻涕		
콩	大豆		
크기	大小		
크다	大		
크리스마스	圣诞节		
큰아버지	伯父		
큰어머니	伯母		
키	个子		
킬로그램	公斤	(kg)	
킬로미터	公里	(km)	
타다	乘坐	버스를 ~	
탁구	乒乓球		
태국	泰国		
태권도	跆拳道		
태어나다	出生		
태풍	台风		
택시	出租车		taxi
탤런트	才能		
터미널	车站		terminal
테니스	网球		
테이블	餐桌		
텔레비전	电视		
토마토	西红柿		
토요일	星期六		
통	封	편지 한 ~	
통장	存折		
통하다	连通		
퇴근하다	下班		
특별히	特别地		
특징	特征		
특히	特别地		
틀다	拧	라디오를 ~	
틀리다	不同		
티셔츠	T恤		
팀	团队		
파	葱	채소	
파란색	蓝色		
파랗다	蓝		
파티	派对		
팔01	胳膊	신체	
팔03	八		
팔다	卖		
팔리다	被卖		
팔십	八十		
팔월	八月		
패션	时装		
펴다	铺开		
편09	篇	영화 한 ~	
편지	信		
편하다	方便、舒适		
평일	平时		
포도	葡萄		
포장	包装		
표	票		
표현	表现		
푹	沉(睡)、酣(睡)		
풀01	草	식물	
풀다	解开		
프랑스	法国		
프로그램	程序		program
피곤하다	疲劳		
피다	(花)开		
피아노	钢琴		
피우다	点(火)		
피자	披萨饼		
필름	胶卷		film
필요하다	需要		
필통	文具盒		笔筒
하나	一个		
하늘	天空		
하늘색	淡蓝色		
하다	做		
하루	一天		
하숙	寄宿		
하숙집	租住的房子		
하얀색	白色		
하얗다	白		
하지만	但是		
학교	学校		
학기	学期		
학년	年级		
학생	学生		
학생증	学生证		
학원	学院		
한	大约		
한강	汉江		
한국	韩国		
한국말	韩语话		
한국어	韩国语		
한글	韩文		
한번	一次		
한복	韩服		
한식	韩食	韓食	
한자	汉字		
할머니	奶奶		
할아버지	爷爷		
할인	折扣		
함께	一起		
합격	合格		
항상	经常		
해	太阳	~가 뜨다	
해외	海外		
해외여행	海外旅行		
핸드폰	手机		
햄버거	汉堡		
햇빛	阳光		
행복	幸福		
행사	活动		
허리	腰		
현금	现金		
현재	现在、当前		
형	兄		
형제	兄弟		
호	号	몇 ~	
호랑이	老虎		
호주	澳大利亚	나라	
호텔	饭店		
혼자	自己		
홈페이지	主页		
홍차	红茶		
화06	火儿	~를 내다	
화가	画家		
화나다	发火		
화내다	发脾气		
화요일	星期二		
화장실	洗手间		
화장품	化妆品		
화장하다	化妆		
확인하다	确认		
환영하다	欢迎		
환자	患者		
회사04	公司		
회사원	职员		
회색	灰色		
회의	会议		
횡단보도	人行道		
후08	后	며칠 ~	
후배	晚辈		
휴가	休假		
휴대전화	手机		
휴일	休息日		
휴지	废纸		
휴지통	废纸桶		
흐리다	阴沉		
흰색	白色		
힘	力量		
힘들다	吃力、困难		
ㅇ (初音)：	形象：像一个鸡蛋（egg），象征着新生命和开始。		
